055555555555550000000000000055555000000002
055555555555555000009939900055555550000002
003399999333005033000000003333009995000002
000000000000005000333300000000000005000002
000000000000333000000000000000000005000002
333300000000000000000003333000000009000002
000000000000000000009000000000000005000002
000000999000000000099990000000000005000802
bbbbb0000000999bbbbbbbbbbb0000000009bbbbb2
222000000333300022222222209000009990002222
220000000000000000222220000093333000000222
220000000003333000222220000000000000000222
220000000333300000222220000000000000000222
220000000000090300222220333000000033300222
220003330000000000222220000000000000000222
220000000000003000222220000333333000000222
220000000000030990222220000000000000000222
220000030003000099222220000000000000000222
220000000000000000222220000000000333333222
220003330000330000222220000000000000000222
220000000000050000222220033330000000000222
220000050003333000222220000000000555550222
220000333000000000222220000000000555550222
220000000000005050222223333009900333330222
223333000000000000222220000000999999999222
22000000000000000022222000bbbbbbbbbbbbb222